FFFFFFFFFFFFFFFFFFFFFFFFFFFFFFFFFIIIIIII
FFFFFFFFFFFFFFFFFFFFFFFFFFFFFFIIIIIIIIII
FFFFFFFFFFFFFFFFFFFFFFFFFFFFFIIIIIIIIIII
FFFFFFFFFFFFFFFFFFFFFFFFFFIIIIIIIIIIIIII
FFFFFFFCFFFFFFFFFFFFFFFFFIIIIIIIIIIIIIII
IIIIIIIIIIIIIIIIIIIIIIIIIIIIIIIIIIIIIIII
IIIIIIIIIIIIIIIIIIIIIIIIIIIIIIIIIIIIIIII
IIIIIIIIIIMMMMMMMIIIIIIIIIIIIIIIIIIIIIII
IIIIIIIIMMMMMMMMMMMIIIIIIIIIIIIIIIIIIIII
IIIIIIIMMMMMMMMMMMMMIIIIIIIIIIIIIIIIIIII
IIIIIIMMMMMMMMMMMMMMIIIIIIIIIIIIIIIIIIII
IIIIIIMMMMMMMMMMMMMIIIIIIIIIIIIIIIIIIIII
IIIIIIIIMMMMMMMMMMIIIIIIIIIIIIIIIIIIIIII
IIIIIIIIIIIIIIIIIIIFFFFFFFFFFFFIIIIIIIII
IIIIIIIIIIIIIIIIIFFFFFFFFFFFFFFIIIIIIIII
IIIIIIIIIIIIIIIIFFFFFFFFFFFFFFFIIIIIIIII
IIIIIIIIIIIIIIIIFFFFFFFFFFFFFFFFIIIIIIII
IIIIIIIIIIIIIIIIFFFFFFFFFFFFFFFFFFFFIIII
IIIIIIIIIIIIIIIIIFFFFFFFFFFFFFIIIIIIIIII
IIIIIIIIIIIIIIIIIIIIIIIIIIIIIIIIIIIIIIII
IIIIIIIIIIIIIIIIIIIIIIIIIIIIIIIIIIIIIIII
IIIIIIIIIIIIIIIIIIIIIIIIIIIIIIIIIIIIIIII
IIIIIIIIIIIIIIIIIIIIIIIIIIIIIIIIIIIIIIII
IIIIIIIIIIIIIIIIIIIIIIIIIIIIIIIIIIIIIIII
IIIIIIIIIIIIIIIIIIIIIIIIIIIIIIIIIIIIIIII
IIIIIIIIIIIIIIIIIIIIIIIIIIIIIIIIIIIIIIII
IIIIIIIIIIIIIIIIIIIIIIIIIIIIIIIIIIIIIIII
IIIIIIIIIIIIIIIIIIIIIIIIIIIIIIIIIIIIIIII
IIIIIIIIIFFFFFFFFFFFFFIIIIIIIIIIIIIIIIII
IIIIIIIFFFFFFFFFFFFFFFFIIIIIIIIIIIIIIIII
IIIIIIFFFFFFFFFFFFFFFFFFFFIIIIIIIIIIIIII
IIIIIFFFFFFFFFFFFFFFFFFFFFIIIIIIIIIIIIII
IIIIIIFFFFFFFFFFFFFFFFFFFIIIIIIIIIIIIIII
IIIIIIFFFFFFFFFFFFFFFFFFIIIIIIIIIIIIIIII
IIIIIIIFFFFFFFFFFFFFFIIIIIIIIIIIIIIIIIII
IIIIIIIIIFFFFFFFFFFIIIIIIIIIIIIIIIIIIIII
IIIIIIIIIIIFFFFFIIIIIIIIIIIIIIIIIIIIIIII
IIIIIIIIIIIICIIIIIIIIIIIIIIIIIIIIIIIIIII
IIIIIIIIIIIIIIIIIIIIIIIIIIIIIIIIIIIIIIII
IIIIIIIIIIIIIIIIIIIIIIIIIIIIIIIIIIIIIIII